{
  "name": "Alright, now we are talking",
  "map": [
    ["S","S","S","S","S","S","S","S","S","S","S","S","S"],
    ["S","O","G","G","P","W","G","G","G","G","D","G","S"],
    ["S","D","W","W","G","W","G","G","G","G","P","G","S"],
    ["S","G","G","G","P","W","G","G","E","P","G","R","S"],
    ["S","G","W","W","W","W","E","E","G","E","R","X","S"],
    ["S","G","G","G","G","G","G","G","G","G","R","R","S"],
    ["S","G","G","R","G","G","G","G","R","R","G","G","S"],
    ["S","G","G","R","G","G","G","G","R","R","G","G","S"],
    ["S","G","G","R","G","G","G","G","G","P","G","G","S"],
    ["S","G","G","G","G","G","G","G","G","G","G","G","S"],
    ["S","P","G","G","G","G","G","R","R","R","W","G","S"],
    ["S","D","G","G","G","G","G","G","G","P","W","G","S"],
    ["S","S","S","S","S","S","S","S","S","S","S","S","S"]
  ]
}