{
  "name": "Boring test level",
  "map": [
    ["S","S","S","S","S","S","S","S","S","S","S","S","S"],
    ["S","O","P","E","E","E","E","E","E","E","E","E","S"],
    ["S","S","S","S","S","S","S","S","S","S","S","E","S"],
    ["S","E","E","E","E","E","E","E","E","E","E","E","S"],
    ["S","E","S","S","S","S","S","S","S","S","S","S","S"],
    ["S","E","E","E","E","E","E","E","E","E","E","E","S"],
    ["S","S","S","S","S","S","S","S","S","S","S","E","S"],
    ["S","E","E","E","E","E","E","E","E","E","E","E","S"],
    ["S","E","S","S","S","S","S","S","S","S","S","S","S"],
    ["S","E","E","E","E","E","E","E","E","E","E","E","S"],
    ["S","S","S","S","S","S","S","S","S","S","S","E","S"],
    ["S","X","P","E","E","E","E","E","E","E","E","E","S"],
    ["S","S","S","S","S","S","S","S","S","S","S","S","S"]
  ]
}